p..........
p..........
p..........
p..........
p..........
p..........
p..........
p..........
p..........
p..........
p..........
pb.........
p..........
p..........
p..........
p..........
p..........
p..........
p..........
ps.........
p..........
p..........
p..........
p.o........
p..........
p..........
p..........
p..........
p..........
p..........
p..........
p..........
p..........
p..........
p..........
p..........
p..........
p..........
ps.........
ps.........
p..........
p..........
p..........
p..........
p..........
p..........
p..........
p..........
p..........
p..........
p..........
p..........
p..........
p..........
p..........
p..........
p..........
p..........
ps.........
ps.........
pp.........
ps.........
ps.........
ps.........
ppp........
ps.........
ps.........
ps.........
pppp.......
p..........
p..........
p..........
p....o.....
p..........
p..........
p..........
p..........
p..........
p..........
p..........
p..........
p..........
p..........
p..........
p..........
p..........
p..........
p..........
ps.........
ps.........
p..........
p..........
p..........
p..........
p..........
p..........
p..........
pp.........
pp.........
pp.........
pp.........
pp.........
pp.........
pp.........
pp.........
pp.........
ps.........
ps.........
ps.........
pp.........
pp.........
pp.........
pp.........
pps........
pp.........
pp.........
pp.........
pp.........
ps.........
ps.........
ps.........
ppp........
ppp........
ppp........
ppp........
ppp........
ppp........
ppps.......
ppp........
ppp........
ppp........
ppp........
ppp........
...........
...........
...........
...P.......
...........
...........
...........
....P......
...........
...........
...........
...........
.....P.....
...........
...........
...........
......P....
...........
...........
...........
.......P...
...........
...........
...........
......p....
......p....
......p....
......p....
......p....
......p....
......p....
......ps...
......psP..
......psP..
......ps...
......p....
......p....
......p....
......p....
......ps...
......psP..
......psP..
......ps...
......p....
......p....
......p....
......p....
.....p.....
.....p.....
.....p.....
.....p.Ps..
.....p.Ps..
.....p.Ps..
.....p.Ps..
.....p.....
.....p.....
.....p.....
......p....
......p....
......p....
......p....
......p....
....ppps...
....ps.....
....p......
....p......
....p......
....p......
....p......
....p......
....p......
...........
...........
....P......
....P......
....P......
....Ps.....
...........
...p.......
...p.......
...p.......
...p.......
...p.......
...p.......
...p.......
...p.......
...ps......
p..........
p.p........
p.p........
p.p........
p.p........
p.p........
...........
...........
...........
...P.......
...........
...........
...........
....P......
...........
...........
...........
.....P.....
.....P.....
...........
...........
...........
.......P...
...........
...........
...........
.....P.....
...........
...p.......
...p....Ps.
...p.......
...p.......
...pb......
...........
...........
...........
